

  ▓▓▓▓▓▓▓▓▓▓▓▓▓▓▓▓▓▓▓▓▓▓▓▓▓▓▓
  ▓    ☠▓           ▓       ▓
  ▓ ▓▓▓▓▓ ▓▓▓▓▓ ▓▓▓▓▓       ▓
  ▓       ▓ ♣♣  ♣ ♣♣▓    ♣♣♣▓
  ▓ ▓▓▓▓▓▓▓▓▓▓▓ ▓▓▓▓▓  ♣♣   ▓       
  ▓       ▓  ♣♣   ♣ ▓♣♣     ▓
  ▓▓▓▓▓▓▓ ▓▓▓▓▓ ▓▓▓▓▓▓▓▓  ♣ ▓
  ▓☺      ▓♣♣♣♣             ▓
  ▓▓▓▓▓▓▓▓▓▓▓▓▓▓▓▓▓▓▓▓▓▓▓▓▓▓▓