


▓▓▓▓▓▓▓▓▓▓▓▓▓▓▓▓▓▓▓▓▓▓▓▓▓▓▓▓▓▓▓▓▓▓▓▓▓▓▓▓▓▓▓▓▓▓▓▓▓▓▓▓▓▓▓▓▓▓▓▓▓▓▓▓▓▓▓▓▓▓▓▓▓▓▓▓▓▓▓▓
▓♣♣♣♣♣♣♣♣♣♣♣♣♣♣▓             ▓                 ▓   ▓▓     ▓      ▓   ▓   ▓    ▓▓
▓♣♣♣▓▓▓▓                     ▓                            ▓                    ▓
▓♣♣♣▓▓▓▓                                                     ▓▓▓▓▓▓▓▓▓▓▓▓▓▓▓▓▓▓▓
▓                            ▓             ♣              ▓                    ▓
▓♣♣♣                         ▓             ♣                                   ▓
▓♣♣♣♣    ▓▓▓▓▓▓▓▓            ▓                            ▓                    ▓
▓ ♣♣♣♣   ▓  ֍   ▓            ▓                            ▓                    ▓
▓  ♣     ▓      ▓            ▓                            ▓     ♣♣♣♣♣♣♣♣♣♣♣♣♣♣♣▓
▓        ▓      ▓▓▓▓▓▓▓▓▓▓▓  ▓                            ▓       ♣♣♣♣♣♣♣♣♣♣♣♣♣▓
▓   ☺♣   ▓                   ▓               ☠           ▓                   ▓
▓   ☺♣   ▓                   ▓               ֍            ▓                    ▓
▓        ▓                   ▓                            ▓                    ▓
▓        ▓▓▓▓▓▓▓▓▓▓▓▓▓▓▓▓▓▓▓▓▓                            ▓                    ▓
▓                            ▓                            ▓                    ▓
▓                  ♣♣♣       ▓                            ▓                    ▓
▓                   ♣        ▓                            ▓                    ▓
▓  ▓▓▓▓▓▓▓▓▓▓▓▓▓▓▓▓▓▓▓▓▓▓▓   ▓                            ▓                    ▓
▓  ▓                     ▓   ▓                            ▓                    ▓
▓  ▓                ■    ▓   ▓                            ▓            	   	   ▓
▓  ▓                     ▓ ♣ ▓                            ▓                    ▓
▓  ▓                     ▓   ▓                            ▓▓▓▓▓▓▓▓▓▓▓▓▓▓▓▓▓▓▓▓ ▓
▓  ▓                     ▓▓▓▓▓                            ▓       ♣♣♣♣♣♣♣♣♣♣♣♣♣▓
▓  ▓                         ▓                            ▓      ♣♣♣♣♣♣♣♣♣♣♣♣♣♣▓
▓  ▓                         ▓                            ▓    ♣♣♣♣♣♣♣♣♣♣♣♣♣♣♣♣▓
▓  ▓  ▓▓▓▓▓▓▓▓▓▓▓▓▓▓▓▓▓▓▓▓▓▓▓▓            ♣♣♣♣♣♣          ▓   ♣♣♣♣♣♣♣♣♣♣♣♣♣♣♣♣♣▓
▓  ▓                         ▓             ♣♣♣♣           ▓♣♣♣♣♣♣♣♣♣♣♣♣♣♣♣♣♣♣♣♣▓
▓  ▓                         ▓                            ▓♣♣♣♣♣♣♣♣♣♣♣♣♣♣♣♣♣♣♣♣▓
▓  ▓                         ▓                            ▓♣♣♣♣♣♣♣♣♣♣♣♣♣♣♣♣♣♣♣♣▓
▓  ▓                         ▓                            ▓♣♣♣♣♣♣♣♣♣♣♣♣♣♣♣♣♣♣♣♣▓
▓                            ▓                            ▓♣♣♣♣♣♣♣♣♣♣♣♣♣♣♣♣♣♣♣♣▓
▓▓▓▓▓▓▓▓▓▓▓▓▓▓▓▓▓▓▓▓▓▓▓▓▓▓▓▓▓▓▓▓▓▓▓▓▓▓▓▓▓▓▓▓▓▓▓▓▓▓▓▓▓▓▓▓▓▓▓▓▓▓▓▓▓▓▓▓▓▓▓▓▓▓▓▓▓▓▓▓
